%%%%%%%%%%%%%%%%%%%%%%%%%%%%
%************%%************%
%*%%%%*%%%%%*%%*%%%%%*%%%%*%
%*%  %*%   %*%%*%   %*%  %*%
%*%%%%*%%%%%*%%*%%%%%*%%%%*%
%**************************%
%*%%%%*%%*%%%%%%%%*%%*%%%%*%
%*%%%%*%%*%%%%%%%%*%%*%%%%*%
%******%%****%%****%%******%
%%%%%%*%%%%%*%%*%%%%%*%%%%%%
     %*%%**********%%*%
     %*%%*%%%  %%%*%%*%
%%%%%%*%%*%      %*%%*%%%%%%
**********%      %**********
%%%%%%*%%*%      %*%%*%%%%%%
     %*%%*%%%%%%%%*%%*%
     %*%%**********%%*%
     %*%%*%%%%%%%%*%%*%
%%%%%%*%%*%%%%%%%%*%%*%%%%%%
%************%%************%
%*%%%%*%%%%%*%%*%%%%%*%%%%*%
%*%%%%*%%%%%*%%*%%%%%*%%%%*%
%***%%****************%%***%
%%%*%%*%%*%%%%%%%%*%%*%%*%%%
%%%*%%*%%*%%%%%%%%*%%*%%*%%%
%******%%****%%****%%******%
%*%%%%%%%%%%*%%*%%%%%%%%%%*%
%*%%%%%%%%%%*%%*%%%%%%%%%%*%
%**************************%
%%%%%%%%%%%%%%%%%%%%%%%%%%%%