%%%%%%%%%%%%%%%%%%%%%%%%%%%%
%**************************%
%**************************%
%**************************%
%**************************%
%**************************%
%**************************%
%**************************%
%%%%%%%%%%%%%%%%%%%%%%%%%%%%