%%%%%%%%%%%%%%%%%%%%%%%%%%%%
%************%%************%
%*%%%%*%%%%%*%%*%%%%%*%%%%*%
%*%%%%*%%%%%*%%*%%%%%*%%%%*%
%*%%%%*%%%%%*%%*%%%%%*%%%%*%
%**************************%
%*%%%%*%%*%%%%%%%%*%%*%%%%*%
%*%%%%*%%*%%%%%%%%*%%*%%%%*%
%******%%****%%****%%******%
%%%%%%%%%%%%%%%%%%%%%%%%%%%%
